WWWWEWWWWWWWWWWWWWWW
WM     W           W
W      W WW  W     W
W        WWG W  K  W
WWWWWWWWWWW  W     W
WWWWWWWWWWWS W     W
W         W  WWWWWWW
W     K   G        W
W         WK W     W
W         W  W K   W
WWWWWWWWWWW  WWWWWWW
WWWWWWWWWWW S  T   W
W         WWWWWWW  W
W  C      W   S    W
WWWWWWWWWTWKWWWWWWWW
WWWWWWWWWT  WWWWWWWW
W   G    TW        W
W GGGG    W       BE
WGGGCGG   WWWWWWWWWW
WWWWWWWWWWWWWWWWWWWW